fiscalDateEnding,grossProfit,totalRevenue,costOfRevenue,costofGoodsAndServicesSold,operatingIncome,sellingGeneralAndAdministrative,researchAndDevelopment,operatingExpenses,investmentIncomeNet,netInterestIncome,interestIncome,interestExpense,nonInterestIncome,otherNonOperatingIncome,depreciation,depreciationAndAmortization,incomeBeforeTax,incomeTaxExpense,interestAndDebtExpense,netIncomeFromContinuingOperations,comprehensiveIncomeNetOfTax,ebit,ebitda,netIncome
2023-12-31,819598000,1158467000,338869000,505214000,399105000,255885000,None,427243000,None,-51875000,None,51875000,None,17886000,None,164608000,365116000,53824000,51875000,311292000,261356000,416991000,581599000,311292000
2023-09-30,584479000,587642000,3163000,193288000,154070000,294845000,None,454462000,None,-31817000,None,31817000,None,15008000,None,159264000,137261000,18737000,31817000,118524000,232649000,169078000,328342000,118524000
2023-06-30,618183000,662733000,44550000,195049000,169253000,298204000,None,450688000,None,-31334000,31334000,31334000,None,16170000,None,150726000,154089000,16282000,31334000,137807000,181213000,185423000,336149000,137807000
2023-03-31,874762000,1540973000,666211000,860927000,422638000,303807000,None,465133000,None,-37370000,37370000,37370000,None,17406000,None,148317000,402674000,45003000,37370000,357671000,327338000,440044000,588361000,357671000
2022-12-31,745760000,1484009000,738249000,923265000,321186000,278554000,None,431807000,None,-36760000,36760000,36760000,None,21191000,None,146020000,305617000,33757000,36760000,271860000,294078000,342377000,488397000,271860000
2022-09-30,531672000,722628000,190956000,190956000,105402000,308276000,None,447313000,None,-27842000,27842000,27842000,None,6559000,None,140194000,84119000,12476000,27842000,71643000,135545000,111961000,252155000,71643000
2022-06-30,567270000,816429000,249159000,431484000,154587000,278452000,None,418340000,None,-26190000,26190000,26190000,None,13263000,None,134231000,141660000,13113000,26190000,128547000,288178000,167850000,302081000,128547000
2022-03-31,778441000,1649819000,871378000,1034730000,385132000,259935000,None,399014000,None,-28928000,48779000,28928000,None,5213000,None,133374000,361417000,36418000,28928000,324999000,446722000,390345000,523719000,324999000
2021-12-31,641623000,1012786000,371163000,530273000,275861000,237906000,None,372132000,None,-19851000,19851000,19851000,None,8702000,None,127856000,264712000,15503000,19851000,249209000,203262000,284563000,412419000,249209000
2021-09-30,484606000,568384000,83778000,283309000,90964000,293034000,None,428677000,None,-14486000,14486000,14486000,None,-16938000,None,124708000,59540000,10820000,14486000,48720000,57284000,74026000,198734000,48720000
2021-06-30,518683000,605553000,86870000,271340000,133390000,265945000,None,390696000,None,-20962000,20962000,20962000,None,5887000,None,119348000,118315000,15904000,20962000,102411000,23179000,139277000,258625000,102411000
2021-03-31,745264000,1319073000,573809000,730184000,381804000,244824000,None,374992000,None,-26096000,26096000,26096000,None,2834000,None,118636000,358542000,61788000,26096000,296754000,434693000,384638000,503274000,296754000
2020-12-31,626220000,914480000,288260000,426903000,298840000,212095000,None,334317000,None,-22010000,22010000,22010000,None,6072000,None,115285000,282902000,65224000,22010000,217678000,277799000,304912000,420197000,217678000
2020-09-30,456883000,474914000,18031000,18031000,100845000,265392000,None,377138000,None,-15494000,15494000,15494000,None,-1962000,None,111746000,83389000,18056000,15494000,65333000,124471000,98883000,210629000,65333000
2020-06-30,466923000,492995000,26072000,175532000,139035000,220784000,None,327888000,None,-19580000,19580000,19580000,None,7235000,None,107104000,126690000,8899000,19580000,117791000,113705000,146270000,253374000,117791000
2020-03-31,659782000,977665000,317883000,317883000,331438000,222428000,None,328344000,None,-22171000,22171000,22171000,None,-2989000,None,105916000,306278000,66632000,22171000,239646000,240536000,328449000,434365000,239646000
2019-12-31,578695000,875563000,296868000,296868000,252781000,220852000,None,325914000,None,-27229000,27229000,27229000,None,4887000,None,105062000,230439000,51766000,27229000,178673000,179725000,257668000,362730000,178673000
2019-09-30,430013000,443683000,13670000,13670000,89715000,263279000,None,364198000,None,-28763000,28763000,28763000,None,9250000,None,100919000,70202000,11796000,28763000,58406000,59486000,98965000,199884000,58406000
2019-06-30,454412000,485738000,31326000,31326000,122202000,234510000,None,332210000,None,-19592000,19592000,19592000,None,1645000,None,97700000,104255000,23789000,19592000,80466000,81613000,123847000,221547000,80466000
2019-03-31,622969000,1094645000,471676000,471676000,297677000,228520000,None,325292000,None,-26949000,54798000,26949000,None,4232000,None,96772000,274960000,60072000,26949000,214888000,212193000,301909000,398681000,214888000
2018-12-31,535617000,877782000,342165000,342165000,236464000,203088000,None,299153000,None,-27849000,None,27849000,None,-7723000,None,96065000,200892000,43246000,27849000,157646000,135388000,228741000,324806000,157646000
2018-09-30,401615000,444700000,43085000,43085000,90629000,277066000,None,369723000,None,-24484000,None,24484000,None,-2090000,None,92657000,64055000,25308000,24484000,38747000,54415000,88539000,181196000,38747000
2018-06-30,431359000,562245000,130886000,130886000,124320000,217695000,None,308366000,None,-23349000,None,23349000,None,-3330000,None,90671000,97641000,26448000,23349000,71193000,79823000,120990000,211661000,71193000
2018-03-31,-977725000,1219409000,950421000,626960000,270902000,234080000,None,323461000,None,-27304000,None,27304000,None,-2167000,None,89381000,241431000,62439000,27304000,178992000,200297000,268735000,358116000,178992000
2017-12-31,-679140000,889192000,647631000,366917000,242083000,192340000,None,280714000,None,-31509000,None,31509000,None,-2557000,None,88374000,208017000,-106115000,31509000,314132000,313070000,239526000,327900000,314132000
2017-09-30,-72561000,464880000,72561000,72561000,91792000,271527000,None,356327000,None,-33710000,None,33710000,0,-10902000,None,84800000,55262000,19409000,33710000,35853000,35198000,88972000,173772000,35853000
2017-06-30,-414335000,526501000,385837000,114176000,140664000,191638000,None,271661000,None,-28498000,None,28498000,0,-289000,None,80023000,111877000,41069000,28498000,70808000,53103000,140375000,220398000,70808000
2017-03-31,-729958000,560692000,703014000,427494000,285172000,197853000,None,275520000,None,-26944000,None,26944000,0,833000,None,77667000,261777000,97049000,26944000,162012000,170488000,288721000,366388000,164728000
2016-12-31,468863000,1039113000,570250000,311305000,209918000,181987000,None,258945000,None,-31030000,None,31030000,6800000,-994000,None,76958000,188888000,63856000,31030000,114038000,220400000,219918000,296876000,125032000
2016-09-30,376011000,439938000,63927000,63927000,84449000,272152000,None,291378000,None,-30207000,-170000,30037000,-12700000,-144000,None,75864000,53658000,19418000,30207000,34850000,24451000,83695000,159559000,34240000
2016-06-30,407311000,903063000,495752000,225605000,128396000,196688000,None,270147000,None,-27698000,-19000,27679000,1900000,1118000,None,72880000,106885000,35692000,27698000,66143000,50199000,134564000,207444000,71193000
2016-03-31,517811000,1400088000,882277000,614482000,251656000,195823000,None,267795000,None,-27560000,-1000,27559000,-2500000,-329000,None,71391000,222575000,80765000,27560000,143003000,87533000,250134000,321525000,141810000
2015-12-31,434427000,1144443000,710016000,462458000,192729000,176319000,None,241698000,None,-30483000,-946000,29537000,-2200000,-879000,None,70656000,163628000,60767000,30483000,101546000,109229000,193165000,263821000,102861000
2015-09-30,354321000,995370000,641049000,302581000,75853000,267731000,None,278468000,None,-31075000,None,31075000,2300000,1815000,None,68349000,36882000,13367000,31075000,14063000,-23574000,67957000,136306000,23515000
2015-06-30,381673000,950467000,568794000,304728000,117607000,195622000,None,264066000,None,-27955000,None,27955000,3700000,634000,None,68444000,90286000,34005000,27955000,56281000,122128000,118241000,186685000,56281000
2015-03-31,520738000,1810596000,1289858000,1019330000,250210000,202506000,None,270528000,None,-27447000,None,27447000,8700000,-1561000,None,68022000,221202000,83518000,27447000,137684000,103795000,248649000,316671000,137684000
2014-12-31,423285000,1494325000,1071040000,835480000,187725000,167967000,None,235560000,None,-29764000,None,29764000,900000,-1707000,None,67593000,156254000,58659000,29764000,97595000,15789000,186018000,253611000,97595000
2014-09-30,337659000,778728000,-2663706000,441069000,83944000,185459000,None,253715000,None,-33739000,None,33739000,5700000,-1213000,None,68256000,48992000,25279000,33739000,83944000,20000,82731000,150987000,23713000
2014-06-30,359533000,1195646000,836113000,583185000,106605000,188973000,None,252928000,None,-31840000,None,31840000,-600000,-374000,None,63955000,74391000,28670000,31840000,45721000,20187000,106231000,170186000,45721000
2014-03-31,496277000,2210519000,1714242000,1468045000,250080000,184890000,None,246197000,None,-31601000,None,31601000,-9300000,-1516000,None,61307000,216963000,83596000,31601000,133367000,107169000,248564000,309871000,133367000
2013-12-31,388957000,1473385000,1084428000,866191000,170720000,157768000,None,218237000,None,-32115000,None,32115000,-800000,-2132000,None,60469000,136473000,49457000,32115000,87016000,111170000,168588000,229057000,87016000
2013-09-30,300440000,300440000,-1849221000,364132000,50383000,189866000,None,250057000,None,-31791000,None,31791000,None,-2140000,None,60191000,16452000,8916000,31791000,7536000,23125000,48243000,108434000,7536000
2013-06-30,316497000,316497000,770981000,540880000,86396000,171972000,None,230101000,None,-32741000,None,32741000,None,-467000,None,58129000,58482000,19714000,32741000,33474000,65991000,91223000,149352000,38768000
2013-03-31,432751000,432751000,1098818000,876245000,210178000,165393000,None,222573000,None,-33331000,None,33331000,None,1712000,None,57180000,182644000,66219000,33331000,112340000,148572000,215975000,273155000,116425000
2012-12-31,362362000,362362000,879233000,671793000,154922000,147861000,None,207440000,None,-30522000,None,30522000,None,698000,None,59579000,128215000,47750000,30522000,77348000,91991000,158737000,218316000,80465000
2012-09-30,249389000,508029000,-1596197000,-1834521000,22791000,174817000,None,226598000,None,-34149000,-253000,33896000,None,-11059000,None,60783000,-13911000,-21878000,34149000,-286000,27840000,19985000,80768000,7967000
2012-06-30,293171000,585831000,501042000,287041000,81546000,154182000,None,211625000,None,-34923000,-14000,34909000,None,-2075000,None,58956000,47680000,16548000,34923000,30144000,16746000,82589000,141545000,31132000
2012-03-31,425787000,1243450000,225899000,799722000,202432000,165627000,None,223355000,None,-36660000,-17000,36643000,None,506000,None,59420000,173322000,64211000,36660000,105910000,121238000,209965000,269385000,109111000
2011-12-31,355392000,1101173000,220175000,1700000,139471000,159260000,None,215921000,None,-35442000,284000,35726000,None,-2016000,None,58366000,107852000,39345000,35442000,65788000,51746000,143578000,201944000,68507000
2011-09-30,237160000,789260000,212311000,547216000,39195000,152388000,None,190203000,None,-38210000,-62000,38148000,None,-2862000,None,56656000,-5431000,-7392000,38210000,1098000,-52245000,32717000,89373000,1961000
2011-06-30,261612000,843615000,232727000,576810000,31394000,164807000,None,232727000,None,-35845000,None,35845000,None,-1430000,None,56932000,-2289000,-1723000,35845000,-1474000,-8829000,33556000,90488000,-566000
2011-03-31,444466000,1617287000,1152465000,1152465000,204624000,170482000,None,242469000,None,-37892000,-17000,37875000,None,26202000,None,55467000,203575000,71366000,37892000,132209000,126617000,241450000,296917000,132209000
2010-12-31,357582000,373957000,783435,781058000,150773000,157290,None,209435000,None,-38917,38856083,38895000,None,-726000,None,54777000,118565000,44568000,38917,73997,116970000,157460000,212237000,73997000
2010-09-30,241392000,786315000,539772000,539772000,38537000,149599000,None,192804000,None,-38891000,-184000,38707000,None,314000,None,52338000,-3459000,-4996000,38891000,244000,-7269000,35248000,87586000,1537000
2010-06-30,247666000,770257000,517029000,517029000,32259000,165831000,None,215407000,None,-37290000,-23000,37267000,None,-798000,None,51940000,-4731000,-1577000,37290000,-3154000,3493000,32536000,84476000,-3154000
2010-03-31,445444000,1940266000,1485945000,1485945000,219757000,None,None,229781000,None,None,None,39582000,None,49000,None,53080000,185007000,70881000,None,None,None,224589000,277669000,114126000
2009-12-31,403003000,1292852000,882003,882003000,186598000,None,None,220253,None,None,None,38708,None,-269,None,53839,93388289,58289,None,None,None,93426997,93480836,93330000
2009-09-30,204775000,650567000,418768000,418768000,2942000,None,None,201833000,None,None,None,36603000,None,-2420000,None,51227000,-28402000,-12450000,None,None,None,8201000,59428000,-15952000
2009-06-30,259640000,780775000,521135000,521135000,43683000,None,None,215957000,None,None,None,41511000,None,1219000,None,54181000,3391000,1427000,None,None,None,44902000,99083000,1964000
