fiscalDateEnding,grossProfit,totalRevenue,costOfRevenue,costofGoodsAndServicesSold,operatingIncome,sellingGeneralAndAdministrative,researchAndDevelopment,operatingExpenses,investmentIncomeNet,netInterestIncome,interestIncome,interestExpense,nonInterestIncome,otherNonOperatingIncome,depreciation,depreciationAndAmortization,incomeBeforeTax,incomeTaxExpense,interestAndDebtExpense,netIncomeFromContinuingOperations,comprehensiveIncomeNetOfTax,ebit,ebitda,netIncome
2023-12-31,1846000000,57445000000,55599000000,55599000000,482000000,1283000000,None,1363000000,None,-8000000,None,8000000,None,16000000,None,63000000,489000000,136000000,8000000,354000000,363000000,497000000,560000000,353000000
2023-09-30,1768000000,54763000000,52995000000,52995000000,-14000000,1197000000,None,1855000000,None,-14000000,14000000,14000000,None,2000000,None,64000000,-27000000,-32000000,14000000,6000000,-9000000,-13000000,51000000,5000000
2023-06-30,1827000000,53453000000,51626000000,51626000000,137000000,1267000000,None,1743000000,None,-15000000,15000000,15000000,0,-1000000,None,101000000,123000000,187000000,15000000,-66000000,-73000000,138000000,239000000,-64000000
2023-03-31,1785000000,50487000000,48702000000,48702000000,572000000,1179000000,None,1188000000,None,-28000000,28000000,28000000,0,0,None,69000000,542000000,197000000,28000000,347000000,349000000,570000000,639000000,345000000
2022-12-31,1663000000,51469000000,49806000000,49806000000,-119000000,1191000000,None,1072000000,None,-25000000,25000000,25000000,0,7000000,None,71000000,-137000000,-7000000,25000000,-130000000,-100000000,-112000000,-41000000,-130000000
2022-09-30,1614000000,49603000000,47989000000,47989000000,137000000,1197000000,None,1507000000,None,-25000000,25000000,25000000,0,-2000000,None,71000000,109000000,-1000000,25000000,111000000,48000000,134000000,205000000,110000000
2022-06-30,1605000000,47103000000,45498000000,45498000000,36000000,1155000000,None,1620000000,None,-34000000,34000000,34000000,0,-30000000,None,99000000,-27000000,-165000000,34000000,137000000,101000000,7000000,106000000,138000000
2022-03-31,1682000000,44836000000,43154000000,43154000000,-97000000,1137000000,None,1307000000,None,-38000000,37000000,38000000,0,-3000000,None,78000000,-138000000,1253000000,38000000,-1390000000,-1383000000,-100000000,-22000000,-1391000000
2021-12-31,1616000000,45457000000,43841000000,43841000000,-950000000,1151000000,None,1271000000,None,-37000000,36000000,37000000,0,13000000,None,79000000,-973000000,-1022000000,37000000,49000000,25000000,-936000000,-857000000,49000000
2021-09-30,1642000000,43968000000,42326000000,42326000000,415000000,1114000000,None,1240000000,None,-40000000,40000000,40000000,-10000000,4000000,None,78000000,368000000,97000000,50000000,272000000,244000000,408000000,486000000,271000000
2021-06-30,1475000000,42586000000,41111000000,41111000000,162000000,1129000000,None,1329000000,None,-44000000,46000000,44000000,-13000000,16000000,None,107000000,120000000,4000000,57000000,701000000,130000000,164000000,271000000,116000000
2021-03-31,1812000000,39275000000,37463000000,37463000000,473000000,1120000000,None,1268000000,None,-45000000,45000000,45000000,0,12000000,None,109000000,439000000,320000000,45000000,760000000,124000000,484000000,593000000,119000000
2020-12-31,1776000000,41541000000,39765000000,39765000000,461000000,1147000000,None,1312000000,None,-46000000,46000000,46000000,0,12000000,None,113000000,426000000,-203000000,46000000,224000000,663000000,472000000,585000000,629000000
2020-09-30,1715000000,39065000000,37350000000,37350000000,-624000000,1137000000,None,2343000000,None,-45000000,45000000,45000000,0,7000000,None,115000000,-663000000,-410000000,45000000,-253000000,-236000000,-618000000,-503000000,-253000000
2020-06-30,1590000000,36689000000,35099000000,35099000000,270000000,1137000000,None,1137000000,None,-49000000,530000000,49000000,-7000000,22000000,None,131000000,340000000,-316000000,56000000,453000000,693000000,389000000,520000000,656000000
2020-03-31,1885000000,39157000000,37272000000,37272000000,562000000,1165000000,None,1324000000,None,-60000000,60000000,60000000,-5000000,-19000000,None,130000000,223000000,-127000000,65000000,351000000,312000000,283000000,413000000,350000000
2019-12-31,1714000000,39735000000,38021000000,38021000000,334000000,1163000000,None,1371000000,None,-63000000,63000000,63000000,-4000000,12000000,None,131000000,161000000,-59000000,67000000,220000000,218000000,224000000,355000000,220000000
2019-09-30,1679000000,37341000000,35662000000,35662000000,-5264000000,1107000000,None,6972000000,None,-66000000,66000000,66000000,0,-14000000,None,133000000,-5345000000,-423000000,66000000,-4921000000,-4944000000,-5279000000,-5146000000,-4922000000
2019-06-30,1674000000,37353000000,35679000000,35679000000,308000000,1168000000,None,1168000000,None,-67000000,67000000,67000000,0,-2000000,None,132000000,238000000,44000000,67000000,506000000,226000000,305000000,437000000,194000000
2019-03-31,1764000000,35228000000,33464000000,33464000000,432000000,1097000000,None,1300000000,None,-75000000,75000000,75000000,0,13000000,None,133000000,370000000,74000000,75000000,296000000,308000000,445000000,578000000,296000000
2018-12-31,1730000000,37740000000,36010000000,36010000000,504000000,1064000000,None,1194000000,None,-76000000,None,76000000,0,-21000000,None,133000000,406000000,126000000,76000000,281000000,253000000,482000000,615000000,280000000
2018-09-30,1667000000,35213000000,33546000000,33546000000,816000000,1155000000,None,1360000000,None,-77000000,None,77000000,0,-3000000,None,133000000,735000000,142000000,77000000,594000000,589000000,812000000,945000000,593000000
2018-06-30,1735000000,35349000000,33614000000,33614000000,-1080000000,1270000000,None,1270000000,None,-78000000,None,78000000,0,-29000000,None,139000000,-1187000000,-21000000,78000000,465000000,-1253000000,-1109000000,-970000000,-1166000000
2018-03-31,1913000000,33633000000,31720000000,31720000000,546000000,1132000000,None,1346000000,None,-84000000,None,84000000,0,2000000,None,148000000,464000000,209000000,84000000,255000000,345000000,548000000,696000000,255000000
2017-12-31,1861000000,35186000000,33325000000,33325000000,399000000,1131000000,None,1362000000,None,-87000000,None,87000000,0,5000000,None,152000000,317000000,-736000000,87000000,1053000000,1044000000,404000000,556000000,1053000000
2017-09-30,1672000000,32641000000,30969000000,30969000000,262000000,1062000000,None,1386000000,None,-81000000,None,81000000,-1000000,-2000000,None,135000000,176000000,61000000,82000000,117000000,154000000,257000000,392000000,115000000
2017-06-30,1623000000,32966000000,31343000000,31343000000,439000000,983000000,None,983000000,None,-67000000,None,67000000,0,3000000,None,104000000,371000000,97000000,67000000,272000000,285000000,438000000,542000000,274000000
2017-03-31,1728000000,31821000000,30093000000,30093000000,605000000,960000000,None,1089000000,None,-46000000,None,46000000,0,5000000,None,96000000,563000000,182000000,46000000,382000000,416000000,609000000,705000000,381000000
2016-12-31,1602000000,33150000000,31548000000,31548000000,542000000,910000000,None,1031000000,None,-44000000,None,44000000,0,-7000000,None,95000000,491000000,167000000,44000000,324000000,270000000,535000000,630000000,324000000
2016-09-30,1590000000,32039000000,30449000000,30449000000,535000000,920000000,None,1038000000,None,-44000000,None,44000000,0,3000000,None,101000000,493000000,184000000,44000000,310000000,309000000,537000000,638000000,309000000
2016-06-30,1665000000,31384000000,29719000000,29718000000,620000000,970000000,None,970000000,None,-44000000,None,44000000,0,0,None,100000000,574000000,241000000,44000000,331000000,300000000,618000000,718000000,333000000
2016-03-31,1689000000,30662000000,28973000000,28973000000,656000000,914000000,None,1013000000,None,-44000000,None,44000000,0,0,None,88000000,612000000,226000000,44000000,386000000,399000000,656000000,744000000,386000000
2015-12-31,1609000000,31445000000,29836000000,29836000000,563000000,922000000,None,1016000000,None,-45000000,None,45000000,0,2000000,None,101000000,520000000,194000000,45000000,326000000,297000000,565000000,666000000,326000000
2015-09-30,1579000000,28055000000,26476000000,26476000000,620000000,842000000,None,938000000,None,-44000000,None,44000000,0,-8000000,None,67000000,567000000,184000000,44000000,384000000,338000000,611000000,678000000,383000000
2015-06-30,1458000000,27547000000,26089000000,26544000000,558000000,847000000,None,847000000,None,-36000000,None,36000000,0,1000000,None,51000000,526000000,231000000,36000000,293000000,325000000,562000000,613000000,295000000
2015-03-31,1459000000,25375000000,23916000000,23916000000,591000000,803000000,None,840000000,None,-35000000,None,35000000,0,2000000,None,48000000,558000000,193000000,35000000,365000000,314000000,593000000,641000000,365000000
2014-12-31,1454000000,25537000000,24083000000,24083000000,546000000,815000000,None,913000000,None,-36000000,None,36000000,-60000000,1000000,None,47000000,451000000,162000000,96000000,289000000,240000000,487000000,534000000,289000000
2014-09-30,1341000000,24070000000,22729000000,22729000000,466000000,775000000,None,879000000,None,-34000000,None,34000000,0,3000000,None,45000000,435000000,169000000,34000000,266000000,242000000,469000000,514000000,266000000
2014-06-30,1256000000,22894000000,21638000000,22068000000,387000000,795000000,None,795000000,None,-33000000,None,33000000,0,3000000,None,50000000,357000000,123000000,33000000,234000000,234000000,390000000,440000000,234000000
2014-03-31,1297000000,21427000000,20130000000,20130000000,508000000,736000000,None,781000000,None,-34000000,None,34000000,0,33000000,None,46000000,507000000,192000000,34000000,315000000,286000000,541000000,587000000,315000000
2013-12-31,1345000000,22240000000,20895000000,20895000000,519000000,766000000,None,840000000,None,-33000000,None,33000000,0,6000000,None,46000000,495000000,217000000,33000000,275000000,285000000,528000000,574000000,278000000
2013-09-30,1264000000,24523000000,23259000000,23259000000,471000000,732000000,None,835000000,None,-33000000,None,33000000,0,4000000,None,46000000,441000000,102000000,33000000,340000000,363000000,474000000,520000000,339000000
2013-06-30,1247000000,25420000000,24173000000,24591000000,-443000000,775000000,None,775000000,None,-36000000,None,36000000,None,-2000000,None,-154000000,-481000000,105000000,36000000,-586000000,-574000000,-445000000,-599000000,-586000000
2013-03-31,1291000000,24552000000,23261000000,23261000000,475000000,712000000,None,845000000,None,-34000000,None,34000000,None,6000000,None,99000000,446000000,101000000,34000000,346000000,327000000,480000000,579000000,345000000
2012-12-31,1224000000,25232000000,24008000000,24008000000,506000000,699000000,None,760000000,None,-27000000,None,27000000,None,4000000,None,88000000,483000000,180000000,27000000,303000000,316000000,510000000,598000000,303000000
2012-09-30,1159000000,25889000000,24730000000,24730000000,457000000,690000000,None,812000000,None,-26000000,None,26000000,None,8000000,None,88000000,438000000,167000000,26000000,272000000,295000000,464000000,552000000,271000000
2012-06-30,1136000000,26764000000,25628000000,25988500000,404000000,712000000,None,712000000,None,-24800000,200000,25000000,None,-2000000,None,86000000,377000000,141000000,24800000,236000000,202000000,402000000,488000000,236000000
2012-03-31,1207000000,26918000000,25711000000,25710800000,527000000,683000000,None,755600000,None,-23900000,100000,24000000,None,7000000,None,83000000,511000000,178000000,23900000,332000000,350000000,535000000,618000000,333000000
2011-12-31,1114000000,27078000000,25964000000,25964100000,449000000,640000000,None,704900000,None,-22900000,100000,23000000,None,0,None,78000000,424000000,162000000,22900000,264000000,257000000,447000000,525000000,262000000
2011-09-30,1084000000,26792000000,25708000000,25707500000,412000000,644000000,None,765900000,None,-23500000,-500000,23000000,None,-4000000,None,78000000,385000000,148000000,23500000,237000000,220000000,408000000,486000000,237000000
2011-06-30,1044000000,26764000000,25720000000,26045900000,358900000,671000000,None,683800000,None,-23800000,200000,24000000,0,2600000,None,73800000,336800000,133800000,23800000,207000000,212600000,360800000,434600000,203000000
2011-03-31,1162000000,26071000000,24909000000,24909200000,447300000,670000000,None,753400000,None,-25100000,None,25100000,0,6200000,None,97500000,421600000,175600000,25100000,250000000,273700000,446700000,544200000,246000000
2010-12-31,994400000,25371300000,24376900000,24377600000,343900000,607300000,None,691500000,None,-21900000,None,21900000,0,5800000,None,73200000,328000000,112800000,21900000,215300000,217600000,349900000,423100000,215200000
2010-09-30,962000000,24438000000,23476000000,23475300000,363900000,581000000,None,688300000,None,-22000000,None,22000000,0,7500000,None,68500000,424800000,129800000,22000000,294000000,262000000,446800000,515300000,295000000
2010-06-30,904100000,24459600000,23555500000,23849000000,334000000,588200000,None,588200000,None,-24600000,-500000,24100000,0,-2700000,None,59600000,338500000,115000000,24600000,193800000,121300000,362600000,422200000,223500000
2010-03-31,1010100000,24342800000,23332700000,23332700000,366300000,628600000,None,667300000,None,-27700000,None,27700000,0,1400000,None,68600000,360800000,138400000,27700000,224800000,194200000,388500000,457100000,222400000
2009-12-31,957700000,24919700000,23962000000,23962000000,366800000,605200000,None,617900000,None,-27400000,None,27400000,0,5600000,None,59500000,369300000,134800000,27400000,230200000,358000000,396700000,456200000,234500000
2009-09-30,908800000,24780700000,23871900000,23871900000,239900000,586100000,None,797700000,None,-33900000,None,33900000,-39900000,8900000,None,66300000,198600000,236800000,73800000,-61800000,-43500000,232500000,298800000,-38200000
2009-06-30,944300000,24347300000,23403000000,23783200000,306700000,591700000,167100000,854100000,None,None,None,32500000,None,15500000,None,57000000,360900000,87700000,None,202000000,None,393400000,450400000,273200000
2009-03-31,986900000,24089300000,23102400000,23537000000,380900000,573000000,None,850200000,None,None,None,30300000,None,-6500000,None,52700000,441900000,129000000,None,215100000,None,472200000,524900000,312900000
2008-12-31,915100000,24117800000,23202700000,23683100000,313100000,578500000,None,858500000,None,None,None,22200000,None,-19700000,None,68700000,418700000,102200000,None,169000000,None,440900000,509600000,316500000
2008-09-30,901200000,23437100000,22535900000,22982700000,286600000,590300000,None,888500000,None,None,None,29300000,None,-2500000,None,47400000,331700000,82600000,None,172200000,None,361000000,408400000,249100000
