fiscalDateEnding,grossProfit,totalRevenue,costOfRevenue,costofGoodsAndServicesSold,operatingIncome,sellingGeneralAndAdministrative,researchAndDevelopment,operatingExpenses,investmentIncomeNet,netInterestIncome,interestIncome,interestExpense,nonInterestIncome,otherNonOperatingIncome,depreciation,depreciationAndAmortization,incomeBeforeTax,incomeTaxExpense,interestAndDebtExpense,netIncomeFromContinuingOperations,comprehensiveIncomeNetOfTax,ebit,ebitda,netIncome
2023-12-31,6882000000,6406200000,-475800000,2842500000,2801900000,730900000,None,1262900000,None,-360200000,63900000,360200000,None,None,None,497500000,2515000000,476000000,360200000,2552600000,2128700000,2875200000,3372700000,2039000000
2023-09-30,4959300000,6692200000,1732900000,625400000,3208300000,583500000,None,1107500000,None,-340700000,340700000,340700000,None,None,None,498000000,2923500000,606400000,340700000,2657800000,2227000000,3264200000,3762200000,2317100000
2023-06-30,4801600000,6497500000,1695900000,618200000,3104100000,567500000,None,1077700000,None,-330200000,330200000,330200000,None,42800000,None,492200000,2816700000,506300000,330200000,2640600000,2344200000,3146900000,3639100000,2310400000
2023-03-31,4255700000,5897800000,1642100000,598300000,2532400000,553300000,None,1043800000,None,-329700000,329700000,329700000,None,64300000,None,490500000,2267000000,464700000,329700000,2132000000,1799500000,2596700000,3087200000,1802300000
2022-12-31,6504700000,5926500000,-578200000,2517600000,2582700000,720300000,None,635100000,None,-322900000,322900000,322900000,1085300000,79100000,None,463100000,2338900000,435500000,322900000,2339500000,1976500000,2661800000,3124900000,1903400000
2022-09-30,4241100000,5872100000,1631000000,589000000,2763900000,576400000,None,1042000000,None,-306200000,306200000,306200000,19000000,78500000,None,465600000,2536200000,554600000,306200000,2287800000,1668300000,2842400000,3308000000,1981600000
2022-06-30,4056400000,5718400000,1662000000,588600000,1711800000,611200000,None,2273400000,None,-290600000,4600000,290600000,-1200000000,-12100000,None,462200000,1409100000,221100000,290600000,1478600000,1583500000,1699700000,2161900000,1188000000
2022-03-31,4017600000,5665600000,1648000000,584000000,2312600000,584300000,None,1064000000,None,-287300000,2600000,287300000,-100000000,-484100000,None,479700000,1541200000,436800000,287300000,1391700000,1036200000,1828500000,2308200000,1104400000
2021-12-31,6515300000,6009100000,-506200000,2748100000,2397100000,755400000,None,1139200000,None,-295600000,295600000,295600000,-241200000,6300000,None,481600000,2107800000,469000000,295600000,2111100000,1728300000,2403400000,2885000000,1638800000
2021-09-30,4579900000,6201300000,1621400000,592600000,2986500000,559600000,None,1028800000,None,-293700000,293700000,293700000,106000000,-1400000,None,469200000,2691400000,541500000,293700000,2443600000,2057900000,2985100000,3454300000,2149900000
2021-06-30,4273000000,5887900000,1614900000,579100000,2691100000,572400000,None,1035800000,None,-296500000,296500000,296500000,98000000,-18600000,None,463400000,2376000000,156700000,296500000,2515800000,2284000000,2672500000,3135900000,2219300000
2021-03-31,3608800000,5124600000,1515800000,571500000,2281300000,490400000,None,944300000,None,-300000000,300000000,300000000,128600000,-28600000,None,453900000,1952700000,415500000,300000000,1837200000,1488100000,2252700000,2706600000,1537200000
2020-12-31,5824399973,5313800000,-510599973,2533600000,2142900000,698000000,None,1107800026,None,-308900000,308900000,308900000,-110800000,-4000000,None,464300000,1830000000,452800000,308900000,1803500000,1549200000,2138900000,2603200000,1377200000
2020-09-30,3955400000,5418100000,1462700000,567900000,2526400000,454700000,None,894800000,None,-310100000,307300000,310100000,None,800000,None,440100000,2217100000,454500000,310100000,2072700000,1810100000,2527200000,2967300000,1762600000
2020-06-30,2223400000,3761500000,1538100000,524500000,961100000,576000000,None,1013600000,None,-319100000,313500000,319100000,None,6700000,None,425700000,648700000,164900000,319100000,802900000,673900000,967800000,1393500000,483800000
2020-03-31,3222600000,4714400000,1491800000,554200000,1693600000,516300000,None,937600000,None,-280000000,5400000,280000000,None,31300000,None,421300000,1444900000,338000000,280000000,1386900000,593200000,1724900000,2146200000,1106900000
2019-12-31,5349000000,5349000000,-669500000,2502900000,2292600000,653600000,None,839600000,None,-283000000,7400000,283000000,None,17200000,None,413600000,2026800000,454600000,283000000,2292600000,1752600000,2309800000,2723400000,1572200000
2019-09-30,3914100000,5502300000,1516500000,559500000,2409300000,543600000,None,957000000,None,-280600000,8900000,280600000,None,23500000,None,413400000,2152200000,544300000,280600000,1888500000,1441400000,2432800000,2846200000,1607900000
2019-06-30,3865200000,5409800000,1476100000,544700000,2273900000,533100000,None,931400000,None,-284200000,10700000,284200000,None,18100000,None,398300000,2007800000,490900000,284200000,1801100000,1540400000,2292000000,2690300000,1516900000
2019-03-31,3530800000,5024100000,1424800000,533100000,2094000000,499100000,None,891700000,None,-274100000,10000000,274100000,None,11400000,None,392600000,1831300000,502900000,274100000,1602500000,1417800000,2105400000,2498000000,1328400000
2018-12-31,5163000000,5163000000,1497400000,509700000,1999500000,609800000,None,936000000,None,-254100000,None,254100000,51700000,6000000,None,379000000,1751400000,336100000,254100000,1999500000,1314100000,2005500000,2384500000,1415300000
2018-09-30,3979700000,5369400000,1389700000,499400000,2417700000,515200000,None,822300000,None,-250100000,None,250100000,68000000,-8900000,None,375100000,2158700000,521400000,250100000,1887400000,1564000000,2408800000,2783900000,1637300000
2018-06-30,3962900000,5353900000,1391000000,483900000,2262300000,542100000,None,907100000,None,-240200000,None,240200000,None,-4000000,None,365000000,2018100000,521800000,240200000,1736500000,1207800000,2258300000,2623300000,1496300000
2018-03-31,3762600000,5138900000,1376300000,480300000,2143100000,533100000,None,896000000,None,-236800000,None,236800000,None,-18400000,None,362900000,1887900000,512500000,236800000,1612200000,1407300000,2124700000,2487600000,1375400000
2017-12-31,5340200000,5340200000,1425000000,464600000,2144200000,617600000,None,869800000,None,-235100000,None,235100000,90600000,-24000000,None,342800000,1885100000,1186400000,235100000,2144200000,757000000,2120200000,2463000000,698700000
2017-09-30,4374500000,5754600000,1380100000,457300000,3079400000,567000000,None,20800000,None,-236700000,None,236700000,902000000,-23200000,None,355800000,2819500000,935800000,236700000,2120400000,2133400000,3056200000,3412000000,1883700000
2017-06-30,4746800000,6049700000,1302900000,438000000,2295100000,525400000,None,864900000,None,-230900000,None,230900000,None,-2800000,None,339500000,2061400000,666300000,230900000,1626000000,1613700000,2292300000,2631800000,1395100000
2017-03-31,4399200000,5675900000,1276700000,430100000,2034000000,521300000,None,846600000,None,-218600000,None,218600000,None,-7900000,None,325300000,1807500000,592700000,218600000,1433400000,1602700000,2026100000,2351400000,1214800000
2016-12-31,6028900000,6028900000,1481100000,434800000,1969000000,627500000,None,1046300000,None,-221200000,None,221200000,102600000,-12900000,None,378900000,1734900000,541500000,221200000,1969000000,723100000,1956100000,2335000000,1193400000
2016-09-30,5033000000,6424100000,1391100000,437600000,2137300000,582900000,None,953500000,None,-221400000,None,221400000,69100000,-11400000,None,370600000,1904500000,629100000,221400000,1496800000,1327600000,2125900000,2496500000,1275400000
2016-06-30,4854700000,6265000000,1410300000,430900000,1857900000,596100000,None,979400000,None,-223900000,None,223900000,None,16200000,None,383300000,1650200000,557300000,223900000,1316800000,820700000,1874100000,2257400000,1092900000
2016-03-31,4527100000,5903900000,1376800000,415100000,1780300000,578000000,None,961700000,None,-218300000,None,218300000,None,14400000,None,383700000,1576400000,451600000,218300000,1316900000,1602000000,1794700000,2178400000,1124800000
2015-12-31,6341300000,6341300000,1561400000,416200000,1880400000,675100000,None,1145200000,None,-180900000,None,180900000,None,11300000,None,389700000,1710800000,504600000,180900000,1880400000,933900000,1891700000,2281400000,1206200000
2015-09-30,5227300000,6615100000,1387800000,416100000,2030300000,584000000,None,971700000,None,-160900000,None,160900000,None,9000000,None,387700000,1878400000,569200000,160900000,1470100000,811700000,2039300000,2427000000,1309200000
2015-06-30,5102100000,6497700000,1395600000,411000000,1849300000,592400000,None,984600000,None,-149200000,None,149200000,None,12300000,None,392200000,1712400000,510000000,149200000,1351600000,1574400000,1861600000,2253800000,1202400000
2015-03-31,4586400000,5958900000,1372500000,403600000,1385500000,582800000,None,968900000,None,-147300000,None,147300000,None,15900000,None,386100000,1254100000,442600000,147300000,958800000,-150800000,1401400000,1787500000,811500000
2014-12-31,6572200000,6572200000,1491400000,421400000,1751700000,662500000,None,1070000000,None,-147800000,5900000,153700000,None,-7800000,None,407500000,1596100000,498600000,147800000,1751700000,174100000,1749800000,2157300000,1097500000
2014-09-30,5566700000,6987100000,1420400000,431200000,2072500000,575800000,None,989200000,None,-149300000,None,149300000,None,-2100000,None,413400000,1921100000,852700000,149300000,1217700000,-79800000,2070400000,2483800000,1068400000
2014-06-30,5711700000,7181700000,1470000000,427600000,2189000000,629200000,None,1180300000,None,-137900000,None,137900000,None,20400000,None,413200000,2071500000,684400000,137900000,1525000000,1494700000,2209400000,2622600000,1387100000
2014-03-31,5252400000,6700300000,1447900000,417100000,1936000000,620400000,None,1166300000,None,-135500000,None,135500000,None,-17200000,None,410400000,1783300000,578500000,135500000,1340300000,1221500000,1918800000,2329200000,1204800000
2013-12-31,7093200000,7093200000,1458100000,421700000,2200400000,627800000,None,1169900000,None,-133500000,5900000,139400000,None,-11700000,None,408600000,2055200000,658200000,133500000,2200400000,1308000000,2194600000,2603200000,1397000000
2013-09-30,5966200000,7323400000,1357200000,408400000,2416700000,554300000,None,1079300000,None,-130500000,None,130500000,None,-13600000,None,394500000,2272600000,750400000,130500000,1652700000,2009600000,2403100000,2797600000,1522200000
2013-06-30,5686800000,7083800000,1397000000,399100000,2197700000,607000000,None,1127700000,None,-129800000,None,129800000,None,-8000000,None,390900000,2059900000,663400000,129800000,1526300000,1031900000,2189700000,2580600000,1396500000
2013-03-31,5222500000,6605300000,1382800000,395200000,1949500000,596500000,None,1115700000,None,-128100000,None,128100000,None,-4600000,None,391100000,1816800000,546600000,128100000,1398300000,867600000,1944900000,2336000000,1270200000
2012-12-31,6952100000,6952100000,1405000000,392700000,2197800000,624500000,None,1141900000,None,-129600000,None,129600000,None,-200000,None,386000000,2068000000,671900000,129600000,2197800000,1583000000,2197600000,2583600000,1396100000
2012-09-30,5770000000,7152400000,1382400000,383400000,2287200000,620900000,None,1127100000,None,-128100000,None,128100000,None,-5500000,None,371900000,2153600000,698600000,128100000,1583100000,1779700000,2281700000,2653600000,1455000000
2012-06-30,5556500000,6915900000,1359400000,376200000,2155000000,617300000,None,1113200000,None,-130000000,None,130000000,None,-15100000,None,365900000,2009900000,662900000,130000000,1477000000,832600000,2139900000,2505800000,1347000000
2012-03-31,5214700000,6546600000,1331900000,374700000,1964600000,592500000,None,1086100000,None,-128900000,None,128900000,None,11800000,None,364700000,1847500000,580800000,128900000,1395600000,1616200000,1976400000,2341100000,1266700000
2011-12-31,6822700000,6822700000,1407000000,378000000,2120000000,661200000,None,1155900000,None,-126900000,None,126900000,None,-9400000,None,367500000,1983700000,607100000,126900000,2120000000,1277800000,2110600000,2478100000,1376600000
2011-09-30,5857500000,7166300000,1308800000,376200000,2394700000,580900000,None,1056600000,None,-124000000,None,124000000,None,-7500000,None,358300000,2263200000,755900000,124000000,1631300000,511400000,2387200000,2745500000,1507300000
2011-06-30,5591900000,6905400000,1313500000,373000000,2189100000,588000000,None,1062300000,None,-121800000,None,121800000,None,-900000,None,350100000,2066400000,656200000,121800000,1532000000,1700400000,2188200000,2538300000,1410200000
2011-03-31,4854600000,6111600000,1257000000,354300000,1825900000,563600000,None,1022800000,None,-120100000,None,120100000,None,-6900000,None,339100000,1698900000,489900000,120100000,1329100000,1710300000,1819000000,2158100000,1209000000
2010-12-31,6214100000,6214100000,1347600000,359800000,1857200000,665800000,None,1104800000,None,-117000000,None,117000000,None,-6600000,None,334100000,1733600000,491300000,117000000,1857200000,1291400000,1850600000,2184700000,1242300000
2010-09-30,5087900000,6304900000,1217000000,344400000,2096500000,556300000,None,987400000,None,-114800000,None,114800000,None,-7200000,None,312700000,1974500000,586100000,114800000,1503200000,2371100000,2089300000,2402000000,1388400000
2010-06-30,4728000000,5945500000,1217500000,334300000,1845300000,564900000,None,991300000,None,-108100000,None,108100000,None,-1900000,None,311500000,1735300000,509500000,108100000,1333900000,434000000,1843400000,2154900000,1225800000
2010-03-31,4375800000,5610100000,1234300000,339300000,1674100000,546300000,None,1006000000,None,-111000000,None,111000000,None,-6200000,None,317900000,1556900000,467100000,111000000,1200800000,855300000,1667900000,1985800000,1089800000
2009-12-31,5973400000,5973400000,1259900000,348400000,1826300000,655800000,None,1026700000,None,-115200000,None,115200000,None,None,None,317700000,1701000000,484200000,115200000,1826300000,1072100000,1816200000,2133900000,1216800000
2009-09-30,4848100000,6046700000,1198600000,338600000,1932800000,549600000,None,977800000,None,-117800000,None,117800000,None,6600000,None,311900000,1821600000,560600000,117800000,1378200000,1757900000,1939400000,2251300000,1261000000
2009-06-30,4492100000,5647200000,1155100000,318000000,1681500000,531500000,None,956400000,None,-119300000,None,119300000,None,29800000,None,304400000,1592000000,498300000,119300000,2288900000,1792500000,1711300000,2015700000,1093700000
2009-03-31,1860200000,5077400000,3217200000,3217200000,1400400000,497300000,None,458600000,None,None,None,120900000,None,None,None,282200000,1372400000,392900000,None,None,None,1493300000,1775500000,979500000
2008-12-31,2075800000,5565000000,3489200000,3489200000,1502200000,622300000,None,547900000,None,None,None,116200000,None,None,None,277800000,1397100000,411800000,None,None,None,1513300000,1791100000,985300000
2008-09-30,2363200000,6267300000,3904100000,3904100000,1823700000,582100000,None,539800000,None,None,None,131600000,None,None,None,311000000,1698900000,507600000,None,None,None,1830500000,2141500000,1191300000
2008-06-30,2224800000,6075300000,3850500000,3850500000,1654200000,598700000,None,600800000,None,None,None,146300000,None,None,None,314300000,1698800000,508300000,None,None,None,1845100000,2159400000,1190500000
